{
    "width": 9,
    "height": 6,
    "lairIndex": 7,
    "castleIndex": 51,
    "warriors": [1,2,3],
    "castleHealth": 5,
    "boardArray": [0, 0, 0, 0, 0, 0, 0, 1, 0,
                   0, 0, 2, 2, 2, 2, 2, 2, 0,
                   0, 0, 2, 0, 0, 0, 0, 2, 0,
                   0, 2, 2, 0, 0, 2, 2, 2, 0,
                   0, 2, 2, 2, 2, 2, 2, 0, 0,
                   0, 2, 2, 2, 0, 0, 3, 0, 0],
    "enemyList": [1,1,1,2,1,1,2,1,2,2,2,3,1,2,3]
}