{
    "width": 9,
    "height": 6,
    "lairIndex": 7,
    "castleIndex": 51,
    "boardArray": [0,  0,  0,  0,  0,  0,  0, 1, 0,
                   0,  0,  2,  2,  2,  2,  2, 2, 0,
                   0,  0,  2,  0,  0,  0,  0, 2, 0,
                   0, 2,  2,  0,  0,  2,  2, 2, 0,
                   0, 2,  2, 2, 2, 2, 2, 0, 0,
                   0, 2, 2, 2,  0,  0, 3, 0, 0]
}